siteID,routeID,native,nonnative,total,easting,northing
101_01,101,444,219,663,507455,3562118
101_02,101,262,156,418,507765,3563197
101_03,101,171,161,332,508686,3563197
101_04,101,225,131,356,508465,3564469
101_05,101,282,243,525,509149,3564153
101_06,101,255,156,411,509733,3565237
101_07,101,241,230,471,509102,3566562
101_08,101,295,201,496,510744,3566147
101_09,101,245,303,548,510123,3567779
101_10,101,326,123,449,511119,3567754
101_11,101,236,92,328,511325,3568072
101_12,101,282,179,461,511686,3569191
102_01,102,284,259,543,508468,3566481
102_02,102,316,519,835,508204,3567234
102_03,102,362,279,641,509715,3567276
102_04,102,443,194,637,509505,3568568
102_05,102,250,108,358,511065,3568389
102_06,102,354,71,425,510663,3569700
102_07,102,355,114,469,510288,3569872
102_08,102,379,40,419,510511,3571188
102_09,102,513,18,531,510705,3572574
102_10,102,438,17,455,511557,3572802
102_11,102,416,107,523,512084,3572892
103_01,103,306,13,319,512199,3570673
103_02,103,417,14,431,512734,3570779
103_03,103,436,28,464,513809,3570239
103_04,103,451,30,481,514608,3570262
103_05,103,366,35,401,515989,3570276
103_06,103,472,38,510,516611,3570213
103_07,103,330,6,336,511226,3571291
103_08,103,356,33,389,517366,3572924
103_09,103,222,7,229,516553,3572993
103_10,103,442,60,502,516963,3573260
103_11,103,394,48,442,516850,3574119
103_12,103,340,12,352,516329,3575610
104_01,104,163,46,209,507650,3563241
104_02,104,187,22,209,507727,3564495
104_03,104,230,28,258,507381,3565621
104_04,104,162,68,230,507967,3565803
104_05,104,175,106,281,507094,3566833
104_06,104,186,115,301,507327,3567382
104_07,104,141,88,229,507082,3568105
104_08,104,154,101,255,508648,3568445
104_09,104,140,75,215,508209,3569807
104_10,104,177,25,202,509244,3570810
104_11,104,205,72,277,509885,3570432
105_01,105,247,110,357,506601,3564099
105_02,105,187,85,272,506628,3565812
105_03,105,409,282,691,506111,3566305
105_04,105,150,55,205,506007,3567292
105_05,105,151,80,231,506176,3568962
105_06,105,179,100,279,506343,3569895
105_07,105,161,97,258,507851,3569441
105_08,105,98,58,156,507833,3570092
105_09,105,139,49,188,508463,3569969
105_10,105,253,23,276,509207,3571877
105_11,105,496,74,570,509430,3571323
105_12,105,145,9,154,509853,3572595
105_13,105,233,33,266,509912,3573294
106_01,106,284,243,527,506704,3562633
106_02,106,214,161,375,505772,3563189
106_03,106,362,149,511,506321,3563574
106_04,106,290,215,505,505164,3564705
106_05,106,298,109,407,505841,3565613
106_06,106,345,102,447,505972,3566295
106_07,106,432,123,555,505692,3567176
106_08,106,361,132,493,505955,3568060
106_09,106,217,88,305,505306,3569493
106_10,106,452,145,597,505607,3570413
106_11,106,358,143,501,506202,3570703
106_12,106,438,34,472,505886,3571625
107_01,107,258,159,417,504878,3565034
107_02,107,228,160,388,504000,3566755
107_03,107,281,81,362,504589,3567918
107_04,107,255,125,380,504428,3568242
107_05,107,294,151,445,504751,3569881
107_06,107,279,98,377,504128,3570690
107_07,107,311,111,422,504821,3571276
107_08,107,325,41,366,506704,3571772
107_09,107,252,15,267,507513,3571895
107_10,107,335,96,431,504132,3572290
107_11,107,137,23,160,505184,3572185
107_12,107,334,17,351,506178,3572739
108_01,108,400,46,446,507093,3572064
108_02,108,480,19,499,508518,3572682
108_03,108,516,83,599,505536,3573412
108_04,108,520,38,558,506155,3573506
108_05,108,344,36,380,507394,3573088
108_06,108,486,169,655,508993,3573907
108_07,108,372,36,408,508505,3574602
108_08,108,268,48,316,508128,3575608
108_09,108,491,26,517,509303,3575421
108_10,108,490,88,578,509449,3576718
108_11,108,328,66,394,509918,3577156
108_12,108,397,16,413,510166,3577478
109_01,109,172,113,285,503695,3571118
109_02,109,156,147,303,503569,3572351
109_03,109,288,26,314,503287,3573637
109_04,109,296,30,326,504688,3573166
109_05,109,269,6,275,504919,3574515
109_06,109,313,12,325,505283,3574016
109_07,109,186,12,198,506099,3574333
109_08,109,166,38,204,507709,3574258
109_09,109,185,50,235,507275,3575780
109_10,109,211,17,228,507220,3576773
109_11,109,239,11,250,508518,3576832
109_12,109,179,9,188,508620,3577564
110_01,110,743,133,876,502823,3572132
110_02,110,835,46,881,502249,3573576
110_03,110,618,43,661,502121,3574454
110_04,110,614,26,640,503627,3574326
110_05,110,77,1,78,503890,3575390
110_05a,110,492,37,529,503555,3575313
110_06,110,660,38,698,504314,3575034
110_07,110,768,109,877,505577,3575721
110_08,110,589,34,623,506785,3575779
110_09,110,603,29,632,506255,3576273
110_10,110,615,38,653,506845,3577431
110_11,110,580,30,610,507447,3577559
110_12,110,465,6,471,506856,3577764
111_01,111,170,61,231,501089,3573523
111_02,111,266,32,298,501630,3574547
111_03,111,272,40,312,501744,3575088
111_04,111,207,60,267,502326,3575727
111_05,111,298,78,376,502963,3576981
111_06,111,225,208,433,503399,3576713
111_07,111,265,74,339,504885,3576981
111_08,111,267,63,330,501592,3577990
111_09,111,242,55,297,502124,3577321
111_10,111,266,71,337,503149,3577498
111_11,111,292,34,326,504489,3577418
111_12,111,314,256,570,501685,3578732
112_01,112,314,126,440,499102,3578747
112_02,112,382,58,440,502027,3578632
112_03,112,386,79,465,503466,3578327
112_04,112,370,28,398,498179,3579118
112_05,112,369,22,391,499680,3579611
112_06,112,300,106,406,502411,3579981
112_07,112,357,40,397,499618,3580845
112_08,112,345,47,392,500175,3580208
112_09,112,360,62,422,501392,3580543
112_10,112,307,62,369,502030,3580007
112_11,112,264,28,292,501297,3581181
112_12,112,398,69,467,502433,3581217
113_01,113,215,28,243,499761,3573453
113_02,113,278,89,367,499646,3574045
113_03,113,245,63,308,499245,3575423
113_03a,113,68,28,96,499911,3575207
113_04,113,254,35,289,500553,3575169
113_05,113,434,149,583,500842,3576973
113_06,113,339,50,389,501948,3576073
113_07,113,394,53,447,500627,3577639
113_08,113,513,84,597,500812,3578715
113_09,113,412,54,466,500651,3579865
113_10,113,222,34,256,501204,3579845
113_10a,113,117,19,136,501873,3579498
114_01,114,425,36,461,498220,3570937
114_02,114,230,65,295,499218,3570967
114_03,114,392,118,510,496913,3571943
114_04,114,337,43,380,497338,3571559
114_05,114,227,52,279,498287,3571460
114_06,114,241,96,337,499511,3571497
114_07,114,373,189,562,500794,3571040
114_08,114,277,171,448,501269,3571121
114_09,114,341,155,496,502731,3570992
114_10,114,385,226,611,495987,3572548
114_11,114,317,27,344,496323,3572671
114_12,114,386,53,439,495185,3573021
115_01,115,328,142,470,498123,3572659
115_02,115,355,199,554,499988,3572027
115_03,115,428,225,653,500232,3572847
115_04,115,298,158,456,501217,3572253
115_05,115,346,181,527,498962,3573297
115_06,115,442,149,591,500960,3573138
115_07,115,288,85,373,498794,3574162
115_08,115,548,93,641,500904,3574237
115_09,115,415,177,592,498115,3575216
115_10,115,452,104,556,498493,3576690
115_11,115,486,53,539,499362,3576715
115_12,115,507,19,526,499995,3577311
116_01,116,357,1,358,491247,3575786
116_02,116,390,44,434,491788,3576802
116_03,116,320,12,332,491776,3577072
116_04,116,347,12,359,492512,3577137
116_05,116,235,65,300,493983,3577288
116_05a,116,22,0,22,493734,3577248
116_06,116,256,37,293,494852,3577679
116_07,116,316,110,426,495917,3577458
116_08,116,290,144,434,496918,3577095
116_09,116,435,61,496,497611,3577477
116_10,116,437,107,544,498537,3577425
116_11,116,334,20,354,497223,3578357
116_11a,116,14,2,16,497556,3578446
116_12,116,227,157,384,498674,3578241
117_01,117,216,47,263,497073,3572902
117_02,117,343,25,368,496495,3573444
117_03,117,241,211,452,497661,3573864
117_04,117,285,45,330,495974,3574638
117_05,117,288,127,415,497943,3574505
117_06,117,276,37,313,496108,3575343
117_07,117,299,200,499,496898,3575240
117_08,117,249,83,332,497302,3576139
117_09,117,276,48,324,495191,3576019
117_10,117,462,158,620,495801,3576737
117_11,117,337,70,407,496393,3576834
117_12,117,251,30,281,497580,3576211
118_01,118,235,0,235,489759,3575567
118_02,118,201,0,201,490743,3575450
118_03,118,216,0,216,487225,3576673
118_04,118,162,0,162,488214,3576203
118_04a,118,7,0,7,488151,3576111
118_05,118,283,11,294,489756,3576265
118_06,118,227,2,229,490636,3576135
118_07,118,196,1,197,487135,3577913
118_08,118,235,5,240,488786,3577571
118_08a,118,37,1,38,488810,3577207
118_09,118,208,16,224,490049,3577015
118_10,118,262,9,271,490394,3577135
119_01,119,320,5,325,491669,3573065
119_02,119,259,8,267,492346,3573732
119_03,119,310,4,314,491743,3574523
119_04,119,324,37,361,492455,3574123
119_05,119,218,3,221,493360,3574818
119_06,119,201,0,201,494113,3574002
119_07,119,255,0,255,495172,3574386
119_08,119,177,0,177,492105,3575049
119_09,119,293,12,305,493141,3575468
119_10,119,198,3,201,493949,3575832
119_11,119,304,9,313,492085,3576860
119_12,119,292,0,292,493695,3576375
120_01,120,158,2,160,490910,3572512
120_02,120,231,0,231,491698,3572644
120_03,120,231,36,267,492359,3572001
120_04,120,240,16,256,493161,3572467
120_05,120,266,2,268,490736,3573680
120_06,120,242,12,254,493439,3573279
120_07,120,165,0,165,488695,3574858
120_08,120,200,1,201,489788,3574257
120_09,120,127,0,127,490033,3574797
120_10,120,119,0,119,488906,3575164
121_01,121,275,20,295,488615,3572434
121_02,121,164,0,164,489680,3571807
121_03,121,192,16,208,490269,3572303
121_04,121,246,5,251,491692,3571654
121_05,121,335,12,347,492249,3571974
121_07,121,259,4,263,489333,3572433
121_09,121,307,3,310,489634,3573862
122_01,122,89,0,89,490122,3569035
122_01a,122,189,0,189,490200,3568866
122_02,122,135,2,137,492298,3569021
122_02a,122,56,0,56,491505,3568544
122_03,122,98,0,98,489042,3569985
122_03a,122,62,0,62,488721,3569567
122_04,122,249,1,250,489513,3569382
122_05,122,304,2,306,490166,3569638
122_06,122,270,0,270,491083,3569816
122_06a,122,67,0,67,491593,3569785
122_07,122,85,0,85,489454,3571511
122_07a,122,84,2,86,488832,3570738
122_07b,122,46,0,46,488653,3571137
122_08,122,64,0,64,489540,3570574
122_08a,122,201,2,203,489030,3570680
122_09,122,314,0,314,490899,3570389
122_12,122,45,0,45,492268,3571384
123_01,123,335,5,340,492868,3569894
123_03,123,293,6,299,492472,3570675
123_04,123,335,15,350,494043,3571059
123_05,123,329,9,338,494359,3570174
123_06,123,360,82,442,493853,3571594
123_07,123,418,68,486,494923,3571915
123_08,123,459,29,488,494536,3572435
123_09,123,307,13,320,494727,3573251
124_01,124,217,0,217,492793,3568648
124_02,124,182,10,192,493081,3568463
124_03,124,269,7,276,494046,3568221
124_04,124,262,3,265,493490,3569331
124_05,124,240,4,244,494492,3569743
124_06,124,269,55,324,495899,3569872
124_07,124,252,56,308,495787,3570847
124_08,124,267,6,273,496260,3570865
124_09,124,174,33,207,497373,3570752
124_10,124,247,17,264,495611,3571200
125_01,125,349,0,349,493547,3563206
125_01a,125,23,1,24,495371,3563787
125_02,125,393,7,400,495687,3564152
125_02a,125,28,0,28,495730,3564327
125_03,125,91,4,95,497061,3564744
125_03a,125,421,78,499,496998,3564771
125_04,125,60,0,60,496109,3565766
125_04a,125,24,0,24,495716,3565727
125_04b,125,183,1,184,496105,3565827
125_05,125,339,2,341,496536,3565502
125_06,125,335,7,342,492365,3567313
125_07,125,309,0,309,494080,3565986
125_07a,125,33,0,33,494382,3566070
125_08,125,182,2,184,495741,3566345
125_09,125,338,15,353,492570,3567733
125_10,125,211,17,228,493456,3567334
125_10a,125,97,1,98,493243,3567024
125_11,125,321,1,322,494540,3567511
125_11a,125,25,0,25,494754,3567316
126_01a,126,20,0,20,493088,3563288
126_02,126,153,0,153,494070,3563500
126_02a,126,12,0,12,494274,3563696
126_03,126,170,0,170,491998,3565052
126_04,126,190,0,190,493187,3564435
126_04a,126,14,0,14,493034,3564930
126_05,126,152,0,152,493924,3564842
126_05a,126,28,0,28,494565,3564301
126_06,126,194,0,194,491860,3565490
126_07,126,223,7,230,493158,3565883
126_07a,126,23,0,23,493158,3565400
126_08,126,157,0,157,494321,3565886
126_08a,126,14,0,14,494470,3565988
126_09,126,146,3,149,493758,3567267
127_02,127,339,1,340,494755,3562171
127_03,127,229,2,231,493258,3560916
127_04a,127,31,0,31,495956,3561831
127_07,127,402,23,425,492177,3562274
127_08,127,184,2,186,493606,3562707
127_09,127,185,0,185,494013,3562508
128_01,128,405,12,417,495804,3562827
128_02,128,352,1,353,496684,3562118
128_03,128,423,49,472,497956,3562049
128_04,128,423,71,494,498376,3562814
128_05,128,304,53,357,499015,3562041
128_06,128,276,204,480,500078,3562269
128_07,128,300,125,425,501260,3562310
128_08,128,285,247,532,502679,3562797
128_09,128,454,92,546,496933,3563660
128_10,128,374,101,475,497425,3563453
129_01,129,310,100,410,497519,3567554
129_02,129,314,112,426,498135,3567103
129_03,129,436,29,465,497592,3568677
129_04,129,270,71,341,498992,3568119
129_05,129,181,119,300,499677,3568066
129_06,129,232,82,314,499952,3568711
129_07,129,405,627,1032,499642,3569196
129_08,129,222,108,330,500938,3569076
129_09,129,357,400,757,500262,3571022
129_10,129,265,208,473,501717,3570767
129_11,129,257,223,480,502638,3570923
129_12,129,345,195,540,503875,3570237
130_01,130,244,5,249,497901,3565829
130_02,130,535,51,586,496796,3566842
130_03,130,442,44,486,497546,3566564
130_04,130,222,3,225,498108,3565920
130_05,130,435,39,474,495907,3567329
130_06,130,358,54,412,496141,3566994
130_06a,130,38,5,43,496072,3566980
130_07,130,320,21,341,495108,3568198
130_08,130,379,41,420,496807,3568736
130_08a,130,43,2,45,496688,3568694
130_09,130,519,44,563,496606,3569838
130_10,130,310,53,363,497856,3569580
130_11,130,277,134,411,498462,3569369
131_01,131,334,27,361,497095,3564697
131_02,131,346,29,375,498100,3564558
131_03,131,297,29,326,498830,3565779
131_04,131,355,15,370,499910,3565356
131_05,131,337,62,399,499491,3566188
131_06,131,637,204,841,499274,3567424
131_07,131,303,168,471,500857,3567005
131_08,131,207,103,310,501816,3567394
131_09,131,181,227,408,501775,3568371
131_10,131,295,120,415,501275,3569780
131_11,131,182,192,374,502381,3569441
131_12,131,179,139,318,503495,3569641
131_13,131,34,11,45,503503,3569602
132_01,132,252,1,253,498425,3563776
132_02,132,166,0,166,499114,3563858
132_03,132,188,0,188,500051,3563598
132_04,132,217,0,217,499832,3564631
132_05,132,256,13,269,500464,3564079
132_06,132,822,271,1093,500966,3565394
132_07,132,196,135,331,500930,3566588
132_08,132,167,111,278,501335,3566330
132_09,132,227,170,397,502927,3566097
132_10,132,210,117,327,502235,3567423
132_11,132,154,144,298,502147,3568073
132_12,132,234,116,350,503187,3568709
133_01,133,56,121,177,502048,3560035
133_02,133,89,125,214,502925,3560028
133_03,133,168,79,247,502967,3560712
133_04,133,85,88,173,502700,3561801
133_05,133,108,49,157,503563,3561264
133_06,133,67,133,200,503123,3562219
133_07,133,92,89,181,501753,3563772
133_08,133,45,111,156,502385,3563482
133_08a,133,16,14,30,502250,3563209
133_09,133,115,115,230,503122,3563106
133_10,133,121,46,167,501390,3564401
133_11,133,108,101,209,502315,3564491
133_12,133,132,23,155,501637,3565379
134_01,134,103,203,306,504408,3558210
134_02,134,117,126,243,504237,3559722
134_03,134,39,10,49,504127,3561267
134_04,134,201,112,313,504520,3561995
134_05,134,148,166,314,504204,3562326
134_06,134,162,130,292,504233,3563945
134_07,134,133,107,240,503398,3564758
134_08,134,248,117,365,504505,3564668
134_09,134,115,100,215,502523,3565609
134_10,134,344,174,518,503435,3565395
134_11,134,222,237,459,503234,3567842
134_12,134,169,210,379,503058,3567202
135_01,135,247,9,256,494680,3558305
135_02,135,321,24,345,495091,3557951
135_03,135,279,4,283,495876,3558476
135_04,135,177,14,191,493314,3558510
135_05,135,264,20,284,494433,3559616
135_06,135,230,52,282,495642,3559515
135_07a,135,79,1,80,496415,3559255
135_08,135,198,0,198,493657,3559688
135_09a,135,177,7,184,493284,3560907
135_09b,135,48,1,49,492603,3560840
135_10,135,250,9,259,495326,3560324
136_01,136,280,60,340,499049,3558482
136_02,136,251,16,267,498202,3559066
136_03,136,228,9,237,498461,3560008
136_04,136,225,4,229,499167,3559022
136_05a,136,30,0,30,497687,3560008
136_06,136,276,2,278,498518,3560864
136_07,136,366,185,551,499492,3560507
136_08,136,231,165,396,500055,3560461
136_09,136,232,162,394,498799,3561746
136_10,136,282,156,438,499639,3561400
136_11,136,207,66,273,501042,3561762
136_12,136,196,24,220,501183,3561965
137_01,137,338,46,384,495045,3556061
137_02,137,334,55,389,496500,3556019
137_03,137,347,52,399,495684,3556258
137_04,137,340,49,389,496488,3556371
137_05,137,224,152,376,497697,3556735
137_06,137,241,26,267,494288,3557483
137_07,137,269,62,331,495284,3557679
137_08,137,283,205,488,496841,3557410
137_09,137,426,191,617,497764,3557710
137_10,137,287,138,425,498508,3557708
137_11,137,308,2,310,497679,3558630
137_12,137,418,27,445,498495,3558661
138_01,138,364,125,489,496741,3554364
138_02,138,223,122,345,497337,3554413
138_03,138,110,73,183,497552,3555991
138_04,138,120,45,165,498060,3555675
138_05,138,87,16,103,498612,3556812
138_06,138,51,118,169,499925,3556734
138_07,138,82,76,158,499582,3557783
138_08,138,86,56,142,500305,3557949
138_09,138,75,27,102,500936,3558114
138_10,138,139,67,206,500782,3559674
138_11,138,133,46,179,501435,3559887
138_12,138,68,71,139,502884,3559624
139_01,139,226,75,301,498394,3554413
139_02,139,392,180,572,499282,3554054
139_03,139,286,119,405,499713,3555266
139_04,139,298,174,472,500127,3555726
139_05,139,245,233,478,501651,3555404
139_06,139,310,113,423,500150,3556864
139_07,139,284,222,506,501879,3556003
139_08,139,191,32,223,501139,3557157
139_09,139,228,238,466,501636,3558219
139_10,139,277,217,494,502202,3558982
139_11,139,150,146,296,503930,3558976
139_12,139,216,244,460,503130,3559422
140_01,140,65,2,67,500430,3554739
140_02,140,45,34,79,501319,3554399
140_03,140,120,87,207,502698,3554680
140_04,140,26,60,86,502653,3555385
140_05,140,42,52,94,502906,3556260
140_06,140,56,61,117,502679,3557901
140_07,140,36,93,129,503198,3557785
140_08,140,82,40,122,504746,3557735
140_09,140,51,58,109,505871,3557705
140_10,140,232,45,277,505599,3558220
140_11,140,36,24,60,505375,3559035
140_12,140,39,12,51,505224,3560914
141_01,141,59,47,106,503687,3555271
141_02,141,83,218,301,503548,3556401
141_03,141,53,228,281,504205,3556819
141_04,141,118,152,270,505065,3556076
141_05,141,56,27,83,506250,3556244
141_06,141,127,64,191,506409,3557067
141_07,141,170,88,258,506190,3558210
141_08,141,164,18,182,506577,3559349
141_09,141,145,81,226,506767,3560154
141_10,141,139,83,222,505629,3561363
141_11,141,119,176,295,506044,3561680
141_12,141,117,167,284,505343,3562311
142_01,142,87,31,118,503628,3554905
142_02,142,36,17,53,504106,3554214
142_03,142,67,37,104,504535,3555343
142_04,142,41,25,66,505442,3555334
142_05,142,55,25,80,506117,3555743
142_06,142,73,24,97,507910,3555345
142_07,142,47,63,110,507804,3556724
142_08,142,69,79,148,507657,3557553
142_09,142,41,2,43,507780,3558696
142_10,142,58,14,72,507003,3559492
142_11,142,50,21,71,507734,3560849
142_12,142,41,26,67,507677,3561508
143_01,143,138,11,149,505765,3554685
143_02,143,104,3,107,506588,3554501
143_03,143,35,9,44,507732,3554506
143_04,143,62,48,110,508531,3554522
143_05,143,58,155,213,509314,3554392
143_06,143,135,277,412,510682,3553981
143_07,143,175,112,287,511781,3554911
143_08,143,130,189,319,512169,3554482
143_09,143,51,97,148,508389,3555702
143_10,143,110,83,193,510175,3555783
143_11,143,226,37,263,511805,3555502
143_12,143,52,1,53,511791,3556291
144_01,144,272,147,419,509317,3555684
144_02,144,282,200,482,509073,3556162
144_03,144,177,166,343,509301,3556319
144_04,144,151,7,158,510845,3556938
144_05,144,161,54,215,508226,3557803
144_06,144,321,53,374,508924,3557386
144_07,144,226,21,247,510180,3557515
144_08,144,100,63,163,508784,3558846
144_09,144,94,27,121,509446,3558532
144_10,144,109,68,177,508136,3559079
144_11,144,87,87,174,509231,3559191
144_12,144,92,8,100,508151,3560546
145_01,145,42,6,48,513405,3554279
145_02,145,32,3,35,514724,3554442
145_03,145,10,0,10,516140,3554649
145_04,145,26,0,26,516596,3554085
145_05,145,25,0,25,517581,3553891
145_06,145,34,0,34,512879,3555914
145_07,145,19,0,19,513401,3555549
145_08,145,31,0,31,514683,3555211
145_09,145,6,0,6,515546,3555319
145_10,145,23,1,24,513387,3556440
145_11,145,19,0,19,514855,3556376
145_12,145,42,2,44,513402,3557010
146_01,146,593,38,631,509409,3574177
146_02,146,582,11,593,510728,3573908
146_03,146,500,55,555,513355,3574261
146_04,146,372,38,410,514718,3574716
146_05,146,592,42,634,511047,3575102
146_06,146,618,16,634,513414,3575237
146_07,146,451,37,488,514524,3575297
146_08,146,493,22,515,510486,3577023
146_09,146,538,31,569,511237,3576625
146_10,146,486,20,506,512493,3576255
146_11,146,392,30,422,513260,3576637
146_12,146,450,47,497,513123,3577018
147_01,147,385,136,521,514190,3572439
147_01a,147,17,3,20,514059,3572397
147_02,147,435,18,453,514736,3572409
147_03,147,509,24,533,510544,3573197
147_04,147,523,21,544,511159,3573970
147_05,147,615,22,637,512393,3573319
147_06,147,426,26,452,513126,3573951
147_07,147,527,55,582,514307,3573844
147_08,147,290,43,333,511742,3574521
147_09,147,462,20,482,512979,3574160
147_10,147,435,20,455,511186,3574940
147_10a,147,9,0,9,511129,3574732
147_11,147,478,9,487,512879,3575246
148_01,148,32,0,32,512618,3571048
148_01a,148,249,28,277,512718,3571000
148_02,148,489,52,541,513656,3571353
148_03,148,396,43,439,514346,3571439
148_04a,148,343,21,364,515351,3571198
148_05,148,479,95,574,515310,3572607
148_06,148,12,0,12,515088,3573449
148_06a,148,349,52,401,515099,3573396
148_07,148,387,52,439,515437,3574644
148_08,148,370,28,398,515995,3575593
148_09,148,429,37,466,514820,3576221
148_10,148,336,10,346,516202,3576066
149_01,149,216,41,257,516986,3568358
149_02,149,238,73,311,517970,3568420
149_02a,149,75,6,81,517924,3568467
149_03,149,279,34,313,518925,3568236
149_04,149,380,7,387,520238,3568850
149_05,149,126,21,147,519336,3569822
149_05a,149,121,3,124,519181,3569788
149_06,149,335,73,408,519609,3570634
149_07,149,198,28,226,519889,3571600
149_07a,149,17,2,19,519584,3571223
149_08,149,173,36,209,519722,3572373
149_09,149,282,10,292,518612,3573973
149_09a,149,99,4,103,518458,3573814
149_10,149,317,33,350,519411,3573250
149_11,149,328,10,338,519702,3574213
149_12,149,85,0,85,519785,3574572
149_12a,149,196,5,201,520134,3574501
150_01,150,320,221,541,509593,3563820
150_02,150,367,18,385,510442,3563628
150_03,150,282,134,416,510469,3564102
150_04,150,309,196,505,511650,3564004
150_05,150,182,157,339,510131,3565156
150_06,150,149,92,241,511844,3565845
150_07,150,394,157,551,512164,3565908
150_08,150,265,242,507,511629,3566810
150_09,150,270,102,372,512520,3566779
150_10,150,414,133,547,512372,3567780
150_11,150,329,92,421,513131,3568090
150_12,150,464,81,545,512223,3569454
151_01,151,520,55,575,515611,3569943
151_02,151,624,45,669,516993,3569438
151_03,151,268,37,305,517594,3569326
151_04,151,397,104,501,518008,3569405
151_05,151,395,17,412,517798,3570698
151_06,151,334,52,386,518516,3570269
151_07,151,413,38,451,517697,3571395
151_08,151,611,7,618,518331,3571849
151_09,151,268,13,281,517343,3572702
151_09a,151,182,12,194,517357,3572644
151_10,151,432,6,438,518210,3572325
151_11,151,455,38,493,517112,3573878
151_12,151,391,27,418,517593,3574034
152_01,152,417,217,634,512009,3563836
152_02,152,169,245,414,512739,3564997
152_03,152,380,174,554,513742,3564483
152_04,152,263,85,348,513339,3565733
152_05,152,637,35,672,513911,3566073
152_06,152,463,130,593,514522,3566041
152_07,152,480,103,583,515392,3566608
152_08,152,250,61,311,513655,3567999
152_09,152,340,87,427,514695,3567377
152_10,152,486,77,563,513132,3568105
153_01,153,321,172,493,517945,3563320
153_02,153,321,69,390,517653,3564580
153_03,153,301,14,315,515969,3565867
153_04,153,215,43,258,516278,3565177
153_04a,153,11,2,13,516437,3565166
153_05,153,396,87,483,517305,3565410
153_06,153,220,144,364,516629,3566628
153_07,153,384,67,451,515663,3567394
153_08,153,402,81,483,516249,3567830
153_09,153,356,57,413,514105,3568621
153_10,153,512,113,625,515520,3568001
153_11,153,361,40,401,513186,3569413
153_12,153,363,26,389,514269,3569302
154_01,154,185,80,265,511312,3562468
154_02,154,228,148,376,512631,3562289
154_03,154,274,143,417,514014,3562525
154_04,154,221,194,415,511976,3563483
154_05,154,173,116,289,513026,3563275
154_06,154,221,59,280,514035,3563871
154_07,154,232,47,279,515645,3563091
154_08,154,161,56,217,516087,3563672
154_09,154,257,126,383,514597,3564712
154_10,154,222,53,275,515864,3564202
154_11,154,229,4,233,516471,3564329
154_12,154,276,39,315,514178,3565802
155_01,155,239,130,369,513789,3561386
155_02,155,210,135,345,514773,3561095
155_03,155,190,26,216,517393,3561630
155_04,155,177,49,226,518088,3561583
155_05,155,216,129,345,519205,3561419
155_06,155,165,59,224,520120,3561677
155_07,155,237,12,249,521797,3561458
155_08,155,259,7,266,522565,3561118
155_09,155,152,121,273,514335,3562156
155_10,155,240,84,324,515151,3562654
155_11,155,187,69,256,516614,3562113
155_12,155,176,64,240,517322,3562021
156_01,156,474,55,529,521755,3568753
156_02,156,581,70,651,520710,3569860
156_03,156,356,77,433,521410,3569501
156_04,156,354,12,366,520352,3570320
156_05,156,694,126,820,520111,3571315
156_06,156,407,12,419,521066,3571625
156_07,156,562,17,579,520388,3572862
156_08,156,378,40,418,521122,3572636
156_09,156,408,9,417,520656,3573187
156_10,156,465,8,473,521513,3573724
156_11,156,276,0,276,521896,3574116
156_12,156,168,0,168,522155,3574217
157_01,157,235,53,288,518452,3562025
157_02,157,211,85,296,518320,3563430
157_03,157,172,115,287,518168,3564142
157_04,157,266,144,410,518887,3564943
157_05,157,66,24,90,517794,3566525
157_05a,157,53,28,81,517778,3566545
157_06,157,239,43,282,518990,3566255
157_07,157,162,8,170,520603,3566775
157_08,157,225,14,239,517389,3567477
157_09,157,185,72,257,518802,3567318
157_10,157,244,16,260,519883,3567481
157_11,157,147,2,149,520430,3567494
157_12,157,192,34,226,520569,3568528
158_01,158,394,72,466,522389,3567599
158_02,158,352,43,395,522009,3568246
158_03,158,424,28,452,522166,3569077
158_04,158,408,24,432,521252,3570866
158_05,158,377,12,389,522509,3570278
158_06,158,394,31,425,522412,3571239
158_07,158,335,37,372,522755,3572662
158_08,158,401,15,416,522455,3573179
158_09,158,212,18,230,523547,3573687
158_09a,158,134,0,134,523254,3573661
158_10,158,325,1,326,523882,3573976
158_11,158,202,1,203,524570,3574717
158_12,158,84,0,84,526260,3574768
158_12a,158,109,0,109,524964,3574163
159_01,159,281,88,369,522658,3566426
159_02,159,375,3,378,523486,3566475
159_03,159,421,8,429,523897,3567796
159_04,159,349,68,417,523779,3568456
159_05,159,537,37,574,523387,3569583
159_06,159,490,28,518,523579,3570441
159_07,159,480,62,542,523130,3571220
159_08,159,467,46,513,523662,3572655
159_09,159,491,16,507,524194,3572114
159_10,159,444,8,452,524375,3573490
159_11,159,317,0,317,525284,3573548
160_01,160,72,0,72,522526,3564718
160_01a,160,333,46,379,522563,3564784
160_02,160,495,26,521,521882,3565745
160_03,160,431,26,457,522203,3565763
160_04,160,33,0,33,523287,3564954
160_04a,160,305,16,321,523470,3564964
160_05,160,310,35,345,524542,3565023
160_06,160,390,138,528,521752,3566407
160_07,160,81,0,81,524672,3566531
160_07a,160,301,3,304,524697,3566503
160_08,160,532,0,532,525115,3567088
160_09,160,610,30,640,526110,3566983
160_10,160,82,0,82,527307,3566568
160_10a,160,232,12,244,527355,3566306
160_11,160,127,0,127,521294,3567658
160_11a,160,249,2,251,521339,3567663
161_01,161,487,2,489,524918,3567731
161_02,161,449,38,487,525475,3567513
161_03,161,385,11,396,524775,3568498
161_04,161,501,72,573,525314,3568123
161_05,161,118,5,123,524280,3569165
161_05a,161,293,4,297,524374,3569360
161_06,161,486,68,554,524647,3570420
161_07,161,514,2,516,524270,3571556
161_08,161,483,11,494,525756,3571388
161_09,161,118,0,118,525329,3572652
161_10,161,421,0,421,526295,3572725
162_01,162,271,4,275,526643,3567854
162_02,162,283,0,283,527828,3567901
162_03,162,259,13,272,526137,3568256
162_04,162,232,1,233,527477,3568395
162_05,162,305,1,306,525550,3569659
162_06,162,295,2,297,526266,3569921
162_07,162,221,4,225,527874,3569698
162_08,162,275,3,278,525780,3570110
162_08a,162,18,0,18,525800,3570296
162_09,162,241,2,243,526480,3570940
162_10,162,257,0,257,526289,3571454
163_01,163,248,22,270,523041,3559695
163_02,163,265,60,325,523733,3560096
163_03,163,235,33,268,523926,3561537
163_04,163,247,149,396,520064,3562841
163_05,163,305,81,386,520790,3562780
163_06,163,253,86,339,521656,3562640
163_07,163,248,74,322,522104,3562683
163_08,163,229,29,258,523159,3562166
163_09,163,241,45,286,519192,3563744
163_10,163,212,86,298,519664,3564689
163_11,163,250,86,336,519646,3565717
163_12,163,244,45,289,519029,3566160
164_01,164,509,269,778,520553,3563826
164_02,164,451,76,527,521609,3563745
164_03,164,456,90,546,522058,3563828
164_04,164,459,0,459,523348,3563938
164_05,164,454,127,581,520299,3564129
164_06,164,360,211,571,521061,3564219
164_07,164,430,4,434,523958,3564334
164_08,164,452,10,462,524051,3564746
164_09,164,338,1,339,525726,3564577
164_10,164,489,69,558,520784,3565583
164_11,164,497,7,504,525751,3565364
165_01,165,296,33,329,525063,3555904
165_02,165,265,12,277,524979,3556849
165_03,165,294,4,298,524712,3558108
165_04,165,187,4,191,526015,3558493
165_05,165,177,3,180,524715,3558921
165_06,165,204,8,212,525071,3558161
165_07,165,286,39,325,524631,3559946
165_08,165,292,25,317,524309,3560213
165_09,165,218,1,219,525078,3560557
165_10,165,246,29,275,524222,3561423
165_11,165,246,3,249,525457,3561666
165_12,165,318,48,366,524521,3562354
165_13,165,320,28,348,524240,3563544
166_01,166,234,115,349,515187,3558535
166_02,166,301,69,370,517117,3558644
166_03,166,373,183,556,515965,3559896
166_04,166,279,82,361,516267,3559439
166_05,166,289,27,316,518123,3559031
166_06,166,282,137,419,515403,3559940
166_07,166,242,177,419,516259,3560069
166_08,166,312,79,391,517601,3560489
166_09,166,315,74,389,518747,3560074
166_09a,166,57,41,98,518562,3560656
166_10,166,208,75,283,515360,3561701
166_11,166,147,60,207,516494,3561646
167_01,167,245,75,320,521614,3557500
167_02,167,224,7,231,522116,3557774
167_03,167,203,24,227,521814,3558531
167_04,167,305,73,378,522227,3558985
167_05,167,211,8,219,523074,3559195
167_05a,167,17,2,19,523267,3558093
167_06,167,230,18,248,521586,3559641
167_07,167,234,18,252,522441,3559561
167_08,167,262,109,371,519371,3560784
167_09,167,283,73,356,520200,3560834
167_10,167,198,9,207,521542,3560399
167_11,167,252,5,257,523010,3559392
167_11a,167,16,0,16,522572,3559597
168_01,168,74,11,85,521419,3555657
168_02,168,52,0,52,522674,3553679
168_03,168,68,0,68,523680,3555008
168_04,168,159,17,176,521660,3555259
168_05,168,171,3,174,522261,3555270
168_06,168,120,2,122,523631,3555774
168_07,168,93,14,107,521727,3556872
168_08,168,180,12,192,522518,3556893
168_09,168,163,55,218,523355,3556887
168_10,168,177,39,216,523080,3557570
169_01,169,106,0,106,519857,3554941
169_02,169,71,0,71,520832,3554287
169_03,169,105,0,105,520717,3555242
169_04,169,112,0,112,520287,3556166
169_05,169,113,1,114,520687,3557806
169_06,169,183,21,204,518209,3558846
169_07,169,153,16,169,519008,3558654
169_08,169,131,96,227,521019,3558763
169_09,169,190,13,203,518883,3559299
169_10,169,134,1,135,519917,3559296
169_11,169,206,96,302,520516,3559297
170_01,170,382,112,494,505873,3576156
170_02,170,294,15,309,505374,3577543
170_03,170,283,19,302,503993,3578496
170_04,170,320,10,330,504513,3578636
170_05,170,297,4,301,506306,3578748
170_06,170,337,28,365,503141,3579408
170_07,170,276,10,286,504057,3579631
170_08,170,264,2,266,505277,3579073
170_09,170,375,69,444,503129,3580106
170_10,170,331,18,349,503317,3581348
170_11,170,295,2,297,503659,3582616
170_12,170,373,4,377,504347,3582747
171_01,171,138,51,189,491211,3557343
171_02,171,189,0,189,492851,3556840
171_03,171,305,42,347,493435,3556807
171_04,171,137,6,143,491285,3558673
171_05,171,185,34,219,492360,3558690
171_06,171,131,35,166,493188,3558756
171_07,171,189,68,257,491806,3559077
171_08,171,176,34,210,492434,3559065
171_09,171,212,24,236,491900,3560578
171_10,171,159,16,175,492423,3560042
171_11,171,240,165,405,491606,3561460
171_12,171,434,154,588,492368,3561742
172_01,172,404,70,474,504150,3583346
172_04,172,369,20,389,504800,3584990
172_05,172,205,7,212,505214,3584693
172_06,172,171,6,177,505606,3584532
172_07,172,329,13,342,505731,3585668
172_08,172,222,4,226,505893,3585429
172_09,172,247,7,254,506527,3586548
173_01,173,236,51,287,498177,3581525
173_02,173,212,52,264,499692,3581806
173_03,173,290,74,364,500750,3581780
173_03a,173,49,3,52,499851,3581130
173_04,173,243,21,264,500163,3582864
173_05,173,326,14,340,501597,3582621
173_06,173,285,30,315,502200,3582666
173_07,173,335,115,450,501246,3583284
173_08,173,288,70,358,502358,3583918
173_09,173,238,64,302,503136,3583154
173_10,173,273,112,385,502598,3584219
173_11,173,335,16,351,503054,3584697
174_01,174,518,3,521,500604,3583229
174_02,174,387,38,425,500561,3584699
174_03,174,238,108,346,501740,3584708
174_04,174,195,41,236,500461,3585811
174_05,174,267,20,287,501618,3585445
174_05a,174,39,2,41,501535,3585476
174_06,174,285,9,294,502234,3585857
174_07,174,567,25,592,502810,3585087
174_08,174,348,6,354,504039,3585244
174_09,174,310,4,314,503343,3586372
174_10,174,304,1,305,504659,3586244
174_11,174,360,53,413,505283,3586722
174_11a,174,50,0,50,505319,3586456
174_12,174,314,7,321,504781,3587334
175_01,175,225,0,225,491728,3578684
175_02,175,203,23,226,492472,3578642
175_03,175,218,34,252,493641,3578257
175_04,175,190,70,260,494764,3578555
175_05,175,230,66,296,495542,3578727
175_06,175,183,59,242,496193,3578722
175_07,175,207,49,256,496151,3579732
175_08,175,272,17,289,497777,3579410
175_09,175,229,29,258,497194,3580706
175_10,175,235,10,245,498309,3580656
175_11,175,245,32,277,497192,3581494
175_12,175,262,6,268,497992,3582449
176_01,176,194,0,194,487439,3578713
176_02,176,161,2,163,488435,3578517
176_02a,176,60,0,60,488660,3578438
176_03,176,278,16,294,489529,3578156
176_04,176,243,16,259,490129,3578173
176_05,176,202,11,213,488391,3579266
176_06,176,149,22,171,489229,3579416
176_07,176,396,25,421,490455,3579683
176_08,176,365,0,365,491484,3579305
176_09,176,112,29,141,488233,3580533
176_10,176,188,49,237,489349,3580135
176_11,176,174,75,249,491623,3580450
176_12,176,223,57,280,492139,3580703
177_01,177,340,100,440,492748,3579429
177_02,177,410,74,484,493296,3579777
177_03,177,442,123,565,494782,3579730
177_04,177,469,225,694,495443,3579170
177_05,177,40,1,41,493257,3580250
177_05a,177,228,7,235,493218,3580781
177_06,177,528,82,610,494603,3580431
177_07,177,322,96,418,495682,3580748
177_08,177,268,78,346,496431,3580641
177_08a,177,240,34,274,496308,3580600
177_09,177,96,2,98,491304,3581197
177_09a,177,203,4,207,491386,3581632
177_10,177,329,122,451,492598,3581865
177_11,177,313,196,509,493625,3581616
177_12,177,221,27,248,494106,3581127
177_12a,177,201,26,227,494363,3581045
178_01,178,206,19,225,490805,3580650
178_02,178,266,18,284,489356,3581322
178_03,178,167,6,173,490397,3581589
178_04,178,269,50,319,495241,3581488
178_05,178,255,45,300,496177,3581441
178_06,178,116,1,117,490725,3582839
178_07,178,164,12,176,491508,3582438
178_08,178,206,20,226,492533,3582363
178_09,178,237,40,277,493854,3582353
178_10,178,160,10,170,494080,3582621
178_11,178,248,38,286,495038,3581971
178_12,178,203,57,260,496236,3582445
179_01,179,115,4,119,486361,3578171
179_02,179,147,0,147,486493,3579770
179_03,179,143,1,144,487383,3579433
179_04,179,116,9,125,486309,3580403
179_05,179,129,26,155,487563,3580450
179_06,179,189,11,200,486798,3581494
179_07,179,46,0,46,487095,3581487
179_07a,179,67,18,85,487129,3581516
179_08,179,146,40,186,488862,3581535
179_09,179,127,2,129,486587,3582207
179_10,179,144,48,192,487552,3582300
179_11,179,113,47,160,488361,3582429
179_12,179,335,3,338,489232,3582088
180_01,180,164,17,181,498606,3582957
180_01a,180,111,0,111,498477,3582834
180_02,180,296,6,302,499854,3581918
180_03,180,315,23,338,493257,3582939
180_04,180,381,25,406,494896,3583789
180_05,180,475,86,561,495831,3583116
180_06,180,363,27,390,496911,3583746
180_07,180,406,18,424,497591,3583591
180_08,180,165,0,165,498665,3583396
180_08a,180,135,1,136,498461,3583450
180_09,180,400,23,423,499329,3583176
180_10,180,290,9,299,497513,3584753
180_11,180,283,0,283,498498,3584039
180_12,180,212,6,218,499657,3584373
181_01,181,128,15,143,502346,3586794
181_01a,181,205,9,214,502544,3586772
181_02,181,97,7,104,501681,3587344
181_02a,181,131,2,133,501584,3587504
181_03,181,312,4,316,502221,3587860
181_04,181,242,3,245,503791,3587423
181_05,181,309,5,314,501552,3588206
181_06,181,391,22,413,502498,3588215
181_07,181,179,64,243,501576,3589312
181_08,181,341,98,439,502275,3589489
181_09,181,288,6,294,501794,3590577
181_10,181,307,15,322,502189,3590837
181_11,181,300,33,333,501207,3591096
182_01,182,357,15,372,498294,3586675
182_02,182,450,64,514,499390,3586467
182_03,182,435,47,482,500796,3586579
182_04,182,386,6,392,501387,3586079
182_05,182,414,33,447,499814,3587114
182_06,182,310,59,369,500677,3587354
182_07,182,295,13,308,500135,3587540
182_08,182,389,3,392,500431,3589199
182_09,182,310,0,310,500214,3590273
182_10,182,328,4,332,500037,3591207
182_11,182,396,29,425,501966,3590712
183_01,183,231,0,231,492839,3583593
183_02,183,222,0,222,492898,3585426
183_03,183,249,6,255,493246,3584273
183_04,183,272,8,280,494621,3584251
183_05,183,221,16,237,495483,3584671
183_06,183,292,36,328,496252,3584459
183_07,183,217,6,223,495402,3585872
183_08,183,257,12,269,496408,3585287
183_09,183,265,4,269,497455,3585062
183_10,183,224,29,253,498777,3585560
183_11,183,318,87,405,499356,3585286
184_01,184,188,38,226,490031,3557225
184_02,184,151,67,218,490323,3557686
184_03a,184,37,0,37,489055,3558321
184_04,184,233,24,257,490805,3558678
184_05,184,261,63,324,489040,3559835
184_06,184,286,48,334,490874,3559798
184_07,184,249,1,250,489453,3561123
184_08,184,257,2,259,490285,3560897
184_09,184,262,10,272,489869,3561364
184_10,184,205,0,205,490258,3561854
184_10a,184,10,0,10,490402,3561736
184_11a,184,65,0,65,490053,3562316
184_12,184,298,31,329,491723,3562505
185_01,185,272,0,272,496853,3560629
185_02,185,228,0,228,497675,3560815
185_03,185,311,2,313,496057,3561438
185_04,185,362,1,363,496822,3561476
185_05,185,446,19,465,497729,3561405
